11111112344544343211111111111111111111111111111111111111111111111111111111111111111111121211111111110
11111123454455454321111111111111111111111111211111111111111111111111111111111111111111232321111111110
11111112345454543211111111111111111111111111121111111111111111111111111111111111111112343432111111110
11111111234454432111111111111111111111111111112111111111111111111111111111111111111123454543211111110
11211111123343321111111111111111111111111111211111111111111111111111111111111111111234345544321111110
12322111112232211111111111111111111111111111112111111111111111111111111111111111112345454555432111110
23433211111121111111111111111111111111111111112111111111111111111111111111111111111234454554321111110
12334321111111111111111111111111111111111111111121111111111111111111111111111111111123345454321111110
23433211111111111111111111111111111111111111111122111111111111111111111111111111111112234343211111110
12343211111111111111111111111111111111111111111112111111111111111111111111111111111111123232111111110
23432111111111111111111111111111111111111111111111211111111111111111111111111111111111112121111111110
12321111111111111111111111111111111111111111111112111111111111111111111111111111111111111111111111110
11211111111111111111111111111111111111111111111111112211111111111111111111111111111111211111111111110
11111111111111111111111111121111111111111111111111111111111111111111111111111111111112322211111111110
11111111111111111111111121232211111111111111111111111211111111111111111111111111111123433321111111110
11111111111111111111111232332321111111111111111111111111111111111111111111111111111123444432111111110
11111111111111111111111232322321111111111111111111111111111111111111111111111111111112343321111111110
11111111111111111111111121211211111111111111111111111121111111111111111111111111111112343211111111110
11111111111111111111111111111111111111111111111111111121111111111111111111111111111111232111111111110
11111111111111111111111111111111111111111111111111111121111111111111111111111111111111121111111111110
