1111111234454434321111111111111111111111111111111111111111111111111111111111111111111112121111111111
1111112345445545432111111111111111111111111121111111111111111111111111111111111111111123232111111111
1111111234545454321111111111111111111111111112111111111111111111111111111111111111111234343211111111
1111111123445443211111111111111111111111111111211111111111111111111111111111111111112345454321111111
1121111112334332111111111111111111111111111121111111111111111111111111111111111111123434554432111111
1232211111223221111111111111111111111111111111211111111111111111111111111111111111234545455543211111
2343321111112111111111111111111111111111111111211111111111111111111111111111111111123445455432111111
1233432111111111111111111111111111111111111111112111111111111111111111111111111111112334545432111111
2343321111111111111111111111111111111111111111112211111111111111111111111111111111111223434321111111
1234321111111111111111111111111111111111111111111211111111111111111111111111111111111112323211111111
2343211111111111111111111111111111111111111111111121111111111111111111111111111111111111212111111111
1232111111111111111111111111111111111111111111111211111111111111111111111111111111111111111111111111
1121111111111111111111111111111111111111111111111111221111111111111111111111111111111121111111111111
1111111111111111111111111112111111111111111111111111111111111111111111111111111111111232221111111111
1111111111111111111111112123221111111111111111111111121111111111111111111111111111112343332111111111
1111111111111111111111123233232111111111111111111111111111111111111111111111111111112344443211111111
1111111111111111111111123232232111111111111111111111111111111111111111111111111111111234332111111111
1111111111111111111111112121121111111111111111111111112111111111111111111111111111111234321111111111
1111111111111111111111111111111111111111111111111111112111111111111111111111111111111123211111111111
1111111111111111111111111111111111111111111111111111112111111111111111111111111111111112111111111111
